**********
* *E *   *
*1*    * *
* ****** *
* S *    *
*   * ****
* ***    *
*     *  *
* 2 * *1 *
**********
