***    ***
*S******E*
*   *    *
*** * ****
  *   *
  * * *
  *****